
C 225,     30,0


NO assets/north.xpm
SO assets/south.xpm


F 220,     30,0

WE           assets/west.xpm
EA assets/east.xpm

        111 111111111111111111111
        1011100000110000000000001
        10110000011100000000000011
        1001000000000000000000001
111111111011000001110000000000001
110000000011000001110111111111111
111101111111110111000000100111
111101111111110111010100100111
110000001101010111000000100001
100000000000000011000000100011
10000000000000001101010000011
11000001110101011111011110N0111
11110001 1110101 100011000001
11111111 1111111 111111111111
