NO 	./textures/north.xpm	
SO ./textures/south.xpm
WE ./textures/west.xpm
EA ./textures/test east.xpm

F 22, 3, 44



        1111111111111111111111111
        1000000000110000000000001
        1011000001110000000000001
        1001000000000000000000011
111111111011000001110000000000001
100000000011000011110111111111111
11110111111111011100000010001
11110111111111011101010010001
11000000110101011100000010001
10000000000000011000000100011
10000000000000011010100100011
11000001110101011111011100001
10110111 1110101 101111110001
11111111 1111111 111111111111