

NO ./textures/north.xpm	
SO ./textures/south.xpm
WE ./textures/west.xpm
EA ./textures/east.xpm

F 22, 3, 44

C 22,30,55	

1111111111111111111111111
1000000000110000000000001
1011000001110000000000001
1001000000000E0000000001111111111
111111111011000001110000000000001
100000000011000011110111111111111
11110111111111011100000010001
11110111111111W1110101001S001
11000000110101011100000010001
11111111111111111111111111111