

NO ./textures/north.xpm	
SO ./textures/south.xpm
WE ./textures/west.xpm
EA ./textures/east.xpm

F 22, 3, 44

C 22,30,55	

	1111
    100W
    1111