NO ./textures/north.xpm

SO ./textures/south.xpm

WE ./textures/west.xpm

EA ./textures/east.xpm

F 22, 3, 44
C 22,30,55	

1111
10E1
1111

1111
1001
1111