NO textures/north.xpm
SO textures/south.xpm
WE textures/west.xpm
EA textures/east.xpm
DO textures/bonus/door_open.xpm
DC textures/bonus/door_closed.xpm

C 192, 192, 192
F 28, 28, 28

111111111111111
111111000111111
1111100S0011111
111100000001111
1110000D0000111
110000000000011
100001111100001
110000111000011
1110000D0000111
111100010001111
111110000011111
111111000111111
111111111111111
