
NO 		./textures/north.xpm
WE ./textures/west.xpm
SO ./textures/south.xpm 
EA ./textures/east.xpm


DC textures/bonus/door_closed.xpm
DO textures/bonus/door_open.xpm

C 192   ,192,   192 
F 28, 28, 28

        1111111111111111111111111
        10000000S0110000000000001
        1011000001110000000000001
        1001000000000000000000011
111111111011000001110000000000001
10000000001100001111011111D111111
11100111111110111000000100001 
1111D111111111011101010010001 
11000000110101011100000010001 
100000000000000D0000000D00011 
10000000000000011010100100011 
11000001110101011111011100001 
10110111 1110101 101111110001 
11111111 1111111 111111111111  